row,col,hsa,hs,ha,thsa,ths,tha
1,1,14,14,0,65,64,1
5,1,9,9,0,66,62,4
8,1,106,106,0,421,402,19
9,1,11,11,0,43,41,2
11,1,35,35,0,341,321,20
13,1,4,4,0,11,9,2
14,1,74,74,0,642,576,66
1,2,62,62,0,273,220,53
5,2,55,55,0,223,203,20
8,2,293,293,0,1184,1127,57
9,2,43,43,0,148,143,5
11,2,165,165,0,1048,958,90
13,2,6,6,0,18,17,1
14,2,201,201,0,1931,1728,203
16,2,6,6,0,16,11,5
1,3,111,111,0,557,462,95
2,3,42,42,0,643,614,29
3,3,11,11,0,192,178,14
4,3,36,36,0,494,477,17
5,3,227,219,8,898,829,69
6,3,57,57,0,678,667,11
7,3,33,33,0,457,445,12
8,3,614,603,11,2515,2386,129
9,3,20,20,0,280,276,4
11,3,824,824,0,4016,3828,188
12,3,34,34,0,78,78,0
13,3,14,11,3,42,34,8
14,3,576,576,0,3467,3162,305
15,3,7,7,0,47,32,15
16,3,10,9,1,42,23,19
1,4,90,90,0,451,394,57
2,4,45,45,0,534,511,23
3,4,4,4,0,165,157,8
4,4,25,25,0,377,346,31
5,4,212,201,11,753,673,80
6,4,60,60,0,646,632,14
7,4,18,18,0,403,388,15
8,4,478,462,16,1796,1701,95
11,4,681,681,0,2923,2797,126
12,4,36,35,1,94,93,1
13,4,12,8,4,20,13,7
14,4,437,437,0,2124,1953,171
15,4,14,14,0,47,40,7
16,4,12,8,4,32,13,19
1,5,48,48,0,215,192,23
2,5,14,14,0,225,211,14
3,5,6,6,0,70,62,8
4,5,16,16,0,162,154,8
5,5,60,56,4,287,255,32
6,5,24,24,0,263,258,5
7,5,11,11,0,150,144,6
8,5,209,209,0,796,765,31
11,5,332,332,0,1589,1519,70
12,5,18,18,0,68,67,1
14,5,182,182,0,1160,1065,95
15,5,3,3,0,11,10,1
16,5,6,4,2,12,8,4
1,6,96,96,0,634,555,79
2,6,64,64,0,735,693,42
3,6,18,18,0,228,211,17
4,6,47,47,0,603,561,42
5,6,259,247,12,1016,926,90
6,6,90,90,0,917,898,19
7,6,49,49,0,563,543,20
8,6,550,526,24,2128,2006,122
11,6,1061,1061,0,4709,4533,176
12,6,109,107,2,300,296,4
13,6,8,7,1,19,15,4
14,6,556,556,0,3116,2830,286
15,6,9,9,0,40,28,12
16,6,23,15,8,45,28,17
1,7,127,127,0,708,607,101
2,7,81,81,0,1061,1015,46
3,7,27,27,0,328,308,20
4,7,59,59,0,770,728,42
5,7,385,369,16,1473,1363,110
6,7,108,108,0,1364,1333,31
7,7,54,54,0,761,736,25
8,7,706,672,34,2631,2482,149
10,7,2,2,0,7,5,2
11,7,1309,1309,0,5442,5227,215
12,7,210,210,0,565,561,4
13,7,3,3,0,12,10,2
14,7,696,696,0,3700,3393,307
15,7,14,14,0,79,71,8
16,7,30,21,9,73,51,22
1,8,96,96,0,435,389,46
2,8,54,54,0,629,607,22
3,8,13,13,0,164,153,11
4,8,37,37,0,456,428,28
5,8,227,214,13,850,757,93
6,8,91,91,0,827,817,10
7,8,20,20,0,452,442,10
8,8,374,357,17,1515,1430,85
11,8,719,719,0,2992,2884,108
12,8,134,134,0,332,329,3
13,8,3,3,0,18,12,6
14,8,405,405,0,2152,1956,196
15,8,22,22,0,66,61,5
16,8,22,12,10,48,33,15
1,9,32,32,0,198,174,24
2,9,19,19,0,269,260,9
3,9,5,5,0,76,73,3
4,9,21,21,0,206,196,10
5,9,83,80,3,381,342,39
6,9,32,32,0,365,361,4
7,9,14,14,0,188,179,9
8,9,165,160,5,582,547,35
11,9,354,354,0,1496,1435,61
12,9,71,71,0,202,199,3
13,9,2,2,0,6,4,2
14,9,196,196,0,1298,1176,122
15,9,9,9,0,31,30,1
16,9,2,2,0,5,5,0
1,10,146,146,0,648,581,67
2,10,56,56,0,785,745,40
3,10,21,21,0,226,219,7
4,10,39,39,0,613,573,40
5,10,292,275,17,1171,1071,100
6,10,84,84,0,1062,1039,23
7,10,48,48,0,548,530,18
8,10,451,428,23,1827,1716,111
11,10,987,987,0,4362,4213,149
12,10,184,182,2,458,453,5
13,10,5,5,0,25,15,10
14,10,587,587,0,3450,3113,337
15,10,16,16,0,81,74,7
16,10,25,17,8,63,34,29
1,11,182,182,0,818,739,79
2,11,104,104,0,1053,1015,38
3,11,23,23,0,321,305,16
4,11,64,64,0,831,784,47
5,11,370,356,14,1439,1302,137
6,11,133,133,0,1421,1400,21
7,11,67,67,0,766,742,24
8,11,601,579,22,2307,2205,102
10,11,2,2,0,12,10,2
11,11,1167,1167,0,4962,4780,182
12,11,235,234,1,588,584,4
13,11,2,1,1,13,5,8
14,11,685,685,0,3964,3585,379
15,11,24,24,0,81,70,11
16,11,28,19,9,71,41,30
1,12,95,95,0,402,373,29
2,12,29,29,0,502,476,26
3,12,9,9,0,149,137,12
4,12,27,27,0,408,386,22
5,12,208,202,6,781,711,70
6,12,48,48,0,683,671,12
7,12,24,24,0,369,354,15
8,12,309,300,9,1205,1140,65
11,12,549,549,0,2271,2164,107
12,12,102,102,0,257,255,2
13,12,2,1,1,10,5,5
14,12,372,372,0,1951,1779,172
15,12,3,3,0,18,18,0
16,12,13,9,4,31,19,12
1,13,32,32,0,203,172,31
2,13,11,11,0,172,168,4
3,13,5,5,0,49,45,4
4,13,17,17,0,166,162,4
5,13,85,85,0,311,288,23
6,13,17,17,0,242,237,5
7,13,7,7,0,137,133,4
8,13,91,83,8,434,405,29
11,13,179,179,0,806,782,24
12,13,32,32,0,79,79,0
14,13,170,170,0,1391,1249,142
15,13,2,2,0,15,15,0
1,14,69,69,0,400,351,49
2,14,38,38,0,384,373,11
3,14,8,8,0,119,116,3
4,14,30,30,0,325,309,16
5,14,138,133,5,545,498,47
6,14,46,46,0,505,498,7
7,14,23,23,0,266,254,12
8,14,249,240,9,966,920,46
11,14,399,399,0,2003,1919,84
12,14,81,79,2,226,222,4
13,14,4,4,0,11,8,3
14,14,444,444,0,2947,2646,301
15,14,8,8,0,38,36,2
16,14,8,4,4,18,8,10
1,15,113,113,0,573,501,72
2,15,45,45,0,757,727,30
3,15,8,8,0,242,226,16
4,15,40,40,0,523,490,33
5,15,266,250,16,1026,920,106
6,15,74,74,0,970,947,23
7,15,41,41,0,562,534,28
8,15,395,380,15,1675,1606,69
11,15,751,751,0,3468,3330,138
12,15,213,213,0,484,483,1
13,15,10,8,2,25,19,6
14,15,751,751,0,4594,4135,459
15,15,16,16,0,50,45,5
16,15,15,9,6,41,23,18
1,16,71,71,0,344,311,33
2,16,45,45,0,475,461,14
3,16,18,18,0,179,167,12
4,16,25,25,0,358,328,30
5,16,165,155,10,585,527,58
6,16,49,49,0,573,557,16
7,16,28,28,0,320,313,7
8,16,244,229,15,1005,946,59
11,16,419,419,0,1969,1891,78
12,16,85,85,0,213,212,1
13,16,5,2,3,15,9,6
14,16,412,412,0,2377,2157,220
15,16,3,3,0,24,18,6
16,16,10,5,5,21,10,11
1,17,39,39,0,187,173,14
2,17,7,7,0,145,142,3
4,17,8,8,0,111,101,10
5,17,47,43,4,197,173,24
6,17,13,13,0,190,180,10
7,17,6,6,0,108,105,3
8,17,72,70,2,324,304,20
10,17,3,3,0,4,3,1
11,17,202,202,0,1173,1093,80
12,17,29,29,0,86,85,1
13,17,2,1,1,4,3,1
14,17,180,180,0,1413,1264,149
16,17,2,2,0,5,5,0
1,18,90,90,0,452,391,61
2,18,31,31,0,363,344,19
3,18,13,13,0,112,104,8
4,18,17,17,0,244,229,15
5,18,114,103,11,452,401,51
6,18,33,33,0,420,409,11
7,18,15,15,0,272,266,6
8,18,228,225,3,858,815,43
10,18,2,2,0,10,8,2
11,18,437,437,0,2245,2131,114
12,18,96,93,3,254,247,7
13,18,2,1,1,2,1,1
14,18,426,426,0,2799,2515,284
15,18,6,6,0,21,17,4
16,18,8,8,0,23,16,7
1,19,133,133,0,676,609,67
2,19,54,54,0,591,574,17
3,19,14,14,0,166,156,10
4,19,25,25,0,442,416,26
5,19,230,219,11,826,747,79
6,19,53,53,0,701,686,15
7,19,28,28,0,449,431,18
8,19,387,373,14,1534,1479,55
11,19,764,764,0,3760,3567,193
12,19,123,121,2,350,346,4
13,19,7,7,0,13,11,2
14,19,666,666,0,4430,3965,465
15,19,7,7,0,46,36,10
16,19,19,14,5,40,23,17
1,20,73,73,0,387,347,40
2,20,34,34,0,371,357,14
3,20,14,14,0,114,108,6
4,20,30,30,0,315,290,25
5,20,186,180,6,573,524,49
6,20,46,46,0,515,508,7
7,20,21,21,0,293,279,14
8,20,226,219,7,847,806,41
11,20,444,444,0,2211,2083,128
12,20,92,90,2,255,252,3
14,20,296,296,0,2053,1862,191
16,20,6,5,1,17,12,5
1,21,32,32,0,182,154,28
2,21,9,9,0,145,141,4
4,21,7,7,0,125,116,9
5,21,40,40,0,202,182,20
6,21,12,12,0,175,173,2
7,21,7,7,0,99,96,3
8,21,77,77,0,352,337,15
11,21,200,200,0,1069,998,71
12,21,23,23,0,68,68,0
13,21,2,2,0,3,2,1
14,21,138,138,0,1206,1097,109
15,21,2,2,0,15,13,2
16,21,9,5,4,15,8,7
1,22,83,83,0,390,360,30
2,22,25,25,0,328,314,14
3,22,7,7,0,103,96,7
4,22,19,19,0,258,240,18
5,22,117,109,8,426,386,40
6,22,31,31,0,427,417,10
7,22,21,21,0,249,239,10
8,22,204,196,8,852,813,39
10,22,2,0,2,6,4,2
11,22,498,498,0,2432,2309,123
12,22,70,70,0,171,169,2
13,22,6,4,2,14,10,4
14,22,357,357,0,2703,2405,298
15,22,8,8,0,31,30,1
16,22,8,6,2,15,10,5
1,23,102,102,0,480,410,70
2,23,37,37,0,608,577,31
3,23,15,15,0,179,168,11
4,23,38,38,0,453,425,28
5,23,220,218,2,763,713,50
6,23,66,66,0,731,718,13
7,23,21,21,0,461,445,16
8,23,328,317,11,1323,1255,68
10,23,2,1,1,7,4,3
11,23,778,778,0,3948,3763,185
12,23,128,128,0,349,348,1
13,23,6,5,1,11,8,3
14,23,629,629,0,4097,3703,394
15,23,6,6,0,41,38,3
16,23,10,4,6,30,14,16
1,24,85,85,0,406,368,38
2,24,27,27,0,453,434,19
3,24,8,8,0,139,136,3
4,24,18,18,0,322,298,24
5,24,155,151,4,551,508,43
6,24,48,48,0,529,515,14
7,24,23,23,0,331,317,14
8,24,240,234,6,845,804,41
10,24,2,2,0,4,4,0
11,24,475,475,0,2123,2005,118
12,24,59,59,0,178,175,3
13,24,8,8,0,21,16,5
14,24,333,333,0,2080,1859,221
15,24,7,7,0,32,30,2
16,24,6,4,2,17,10,7
1,25,28,28,0,171,156,15
2,25,11,11,0,110,104,6
3,25,5,5,0,35,33,2
4,25,8,8,0,98,90,8
5,25,45,45,0,165,159,6
6,25,12,12,0,145,143,2
7,25,4,4,0,87,84,3
8,25,64,62,2,313,292,21
11,25,184,184,0,1046,981,65
12,25,25,25,0,76,76,0
13,25,2,1,1,5,4,1
14,25,139,139,0,1205,1090,115
15,25,4,4,0,13,13,0
16,25,4,2,2,14,8,6
1,26,76,76,0,360,314,46
2,26,23,23,0,267,258,9
3,26,7,7,0,61,58,3
4,26,14,14,0,220,208,12
5,26,109,105,4,402,375,27
6,26,27,27,0,353,347,6
7,26,10,10,0,203,195,8
8,26,212,200,12,842,784,58
11,26,413,413,0,2139,2018,121
12,26,67,64,3,189,185,4
13,26,3,3,0,14,14,0
14,26,412,412,0,2873,2568,305
15,26,2,2,0,14,13,1
16,26,9,6,3,17,10,7
1,27,96,96,0,504,437,67
2,27,41,41,0,522,509,13
3,27,18,18,0,166,158,8
4,27,36,36,0,387,364,23
5,27,184,174,10,691,626,65
6,27,54,54,0,686,669,17
7,27,34,34,0,398,387,11
8,27,310,297,13,1236,1172,64
11,27,720,720,0,3666,3482,184
12,27,89,88,1,273,269,4
13,27,6,4,2,16,8,8
14,27,636,636,0,4535,4057,478
15,27,7,7,0,23,20,3
16,27,9,6,3,34,12,22
1,28,71,71,0,342,311,31
2,28,35,35,0,396,371,25
3,28,10,10,0,118,110,8
4,28,22,22,0,271,250,21
5,28,120,112,8,499,450,49
6,28,31,31,0,437,424,13
7,28,20,20,0,252,241,11
8,28,240,230,10,925,866,59
10,28,3,3,0,6,5,1
11,28,452,452,0,2023,1923,100
12,28,49,48,1,145,143,2
13,28,6,6,0,18,12,6
14,28,331,331,0,2318,2075,243
15,28,3,3,0,16,16,0
16,28,6,3,3,18,8,10
1,29,25,25,0,129,114,15
2,29,16,16,0,133,129,4
3,29,3,3,0,34,33,1
4,29,6,6,0,81,76,5
5,29,29,27,2,158,139,19
6,29,11,11,0,137,132,5
7,29,9,9,0,92,91,1
8,29,75,72,3,303,290,13
11,29,173,173,0,833,791,42
12,29,20,20,0,61,60,1
13,29,3,2,1,4,3,1
14,29,147,147,0,1236,1109,127
1,30,67,67,0,304,275,29
2,30,30,30,0,294,279,15
3,30,6,6,0,88,77,11
4,30,11,11,0,215,197,18
5,30,78,76,2,361,320,41
6,30,33,33,0,372,364,8
7,30,15,15,0,201,201,0
8,30,189,182,7,790,754,36
11,30,423,423,0,1826,1732,94
12,30,63,63,0,164,162,2
13,30,5,3,2,11,6,5
14,30,361,361,0,2934,2594,340
15,30,2,2,0,22,14,8
16,30,9,6,3,21,9,12
1,31,160,160,0,531,489,42
2,31,216,216,0,795,769,26
3,31,61,61,0,253,237,16
4,31,170,170,0,627,597,30
5,31,434,410,24,1034,930,104
6,31,299,299,0,996,988,8
7,31,137,137,0,551,537,14
8,31,542,523,19,1390,1308,82
10,31,2,2,0,7,4,3
11,31,1453,1453,0,4347,4170,177
12,31,111,107,4,283,276,7
13,31,4,3,1,9,7,2
14,31,1054,1054,0,4166,3861,305
15,31,13,13,0,56,47,9
16,31,7,5,2,16,10,6
1,32,132,132,0,446,409,37
2,32,178,178,0,671,646,25
3,32,57,57,0,188,177,11
4,32,112,112,0,467,437,30
5,32,348,326,22,807,730,77
6,32,251,251,0,792,775,17
7,32,146,146,0,512,498,14
8,32,408,395,13,990,947,43
10,32,2,2,0,5,5,0
11,32,1072,1072,0,3143,3008,135
12,32,86,83,3,179,175,4
13,32,3,2,1,10,6,4
14,32,737,737,0,2502,2298,204
15,32,16,16,0,50,38,12
16,32,7,4,3,15,5,10
1,33,87,87,0,257,235,22
2,33,96,96,0,295,284,11
3,33,27,27,0,91,85,6
4,33,56,56,0,201,189,12
5,33,138,132,6,376,349,27
6,33,105,105,0,338,333,5
7,33,54,54,0,184,181,3
8,33,180,172,8,475,448,27
11,33,488,488,0,1433,1374,59
12,33,41,41,0,105,105,0
13,33,4,4,0,12,10,2
14,33,368,368,0,1434,1298,136
15,33,3,3,0,11,9,2
16,33,6,6,0,18,10,8
1,34,160,160,0,533,488,45
2,34,250,250,0,872,835,37
3,34,74,74,0,281,267,14
4,34,182,182,0,675,634,41
5,34,389,368,21,1051,939,112
6,34,299,299,0,1051,1025,26
7,34,165,165,0,582,567,15
8,34,524,507,17,1259,1208,51
11,34,1356,1356,0,3938,3777,161
12,34,102,102,0,268,266,2
13,34,3,2,1,14,13,1
14,34,1020,1020,0,3834,3456,378
15,34,15,15,0,38,35,3
16,34,12,6,6,26,12,14
1,35,180,180,0,721,668,53
2,35,323,323,0,1217,1187,30
3,35,108,108,0,395,383,12
4,35,243,243,0,883,836,47
5,35,570,547,23,1506,1397,109
6,35,447,447,0,1498,1472,26
7,35,221,221,0,855,833,22
8,35,595,564,31,1515,1412,103
10,35,7,6,1,23,20,3
11,35,1393,1393,0,3994,3852,142
12,35,131,131,0,383,377,6
13,35,4,1,3,15,7,8
14,35,1181,1181,0,4483,4079,404
15,35,9,9,0,35,31,4
16,35,23,11,12,36,19,17
1,36,161,161,0,525,485,40
2,36,227,227,0,844,824,20
3,36,69,69,0,265,259,6
4,36,150,150,0,603,572,31
5,36,410,375,35,1032,927,105
6,36,279,279,0,952,934,18
7,36,167,167,0,575,554,21
8,36,413,399,14,987,950,37
10,36,2,2,0,3,3,0
11,36,856,856,0,2592,2460,132
12,36,95,94,1,209,205,4
13,36,3,1,2,8,4,4
14,36,769,769,0,2695,2439,256
15,36,9,9,0,33,28,5
16,36,20,13,7,33,19,14
1,37,84,84,0,293,260,33
2,37,91,91,0,386,371,15
3,37,31,31,0,131,121,10
4,37,55,55,0,242,226,16
5,37,158,148,10,437,400,37
6,37,110,110,0,392,377,15
7,37,52,52,0,213,209,4
8,37,153,145,8,379,360,19
10,37,3,3,0,4,4,0
11,37,387,387,0,1205,1172,33
12,37,48,48,0,122,121,1
13,37,3,2,1,6,4,2
14,37,366,366,0,1539,1385,154
15,37,10,10,0,28,28,0
16,37,12,5,7,18,7,11
1,38,180,180,0,654,587,67
2,38,266,266,0,1045,996,49
3,38,75,75,0,353,321,32
4,38,183,183,0,781,733,48
5,38,475,456,19,1254,1138,116
6,38,335,335,0,1199,1176,23
7,38,202,202,0,702,685,17
8,38,420,410,10,1120,1071,49
10,38,10,7,3,26,20,6
11,38,1009,1009,0,2988,2869,119
12,38,136,136,0,319,319,0
13,38,5,4,1,17,10,7
14,38,1017,1017,0,4227,3875,352
15,38,26,26,0,71,67,4
16,38,20,9,11,50,28,22
1,39,279,279,0,911,829,82
2,39,336,336,0,1258,1212,46
3,39,117,117,0,414,383,31
4,39,263,263,0,986,941,45
5,39,602,571,31,1572,1441,131
6,39,434,434,0,1492,1466,26
7,39,265,265,0,923,895,28
8,39,499,485,14,1360,1294,66
10,39,2,2,0,8,5,3
11,39,1168,1168,0,3494,3335,159
12,39,168,165,3,412,406,6
13,39,3,2,1,13,11,2
14,39,1219,1219,0,4856,4415,441
15,39,27,27,0,80,70,10
16,39,32,23,9,66,37,29
1,40,129,129,0,465,428,37
2,40,154,154,0,601,580,21
3,40,53,53,0,187,175,12
4,40,110,110,0,445,416,29
5,40,316,294,22,773,690,83
6,40,187,187,0,754,740,14
7,40,121,121,0,463,447,16
8,40,344,330,14,870,817,53
10,40,4,3,1,6,4,2
11,40,623,623,0,1962,1867,95
12,40,92,91,1,225,223,2
13,40,4,1,3,7,4,3
14,40,710,710,0,2690,2462,228
15,40,16,16,0,60,46,14
16,40,13,5,8,26,11,15
1,41,51,51,0,192,168,24
2,41,63,63,0,228,213,15
3,41,17,17,0,71,63,8
4,41,33,33,0,168,160,8
5,41,97,92,5,283,263,20
6,41,79,79,0,294,280,14
7,41,37,37,0,185,181,4
8,41,103,97,6,363,340,23
11,41,185,185,0,633,603,30
12,41,36,35,1,86,83,3
13,41,2,2,0,4,4,0
14,41,361,361,0,1613,1462,151
16,41,2,2,0,4,3,1
1,42,116,116,0,473,426,47
2,42,144,144,0,533,508,25
3,42,38,38,0,160,146,14
4,42,121,121,0,441,417,24
5,42,252,238,14,684,629,55
6,42,135,135,0,624,612,12
7,42,114,114,0,379,367,12
8,42,243,233,10,665,618,47
11,42,409,409,0,1565,1497,68
12,42,72,72,0,187,187,0
13,42,3,3,0,7,6,1
14,42,738,738,0,3504,3148,356
15,42,5,5,0,15,15,0
16,42,9,6,3,16,10,6
1,43,216,216,0,727,673,54
2,43,282,282,0,986,959,27
3,43,63,63,0,286,267,19
4,43,214,214,0,779,746,33
5,43,474,444,30,1255,1139,116
6,43,351,351,0,1241,1211,30
7,43,185,185,0,725,694,31
8,43,459,443,16,1183,1123,60
10,43,3,3,0,12,10,2
11,43,913,913,0,3096,2927,169
12,43,88,86,2,216,211,5
13,43,3,3,0,8,6,2
14,43,1320,1320,0,5358,4846,512
15,43,10,10,0,29,27,2
16,43,10,6,4,31,12,19
1,44,160,160,0,567,519,48
2,44,195,195,0,648,620,28
3,44,55,55,0,193,186,7
4,44,121,121,0,517,493,24
5,44,356,336,20,927,830,97
6,44,242,242,0,819,801,18
7,44,144,144,0,477,455,22
8,44,338,326,12,874,834,40
11,44,608,608,0,2031,1921,110
12,44,81,80,1,221,216,5
13,44,3,2,1,9,6,3
14,44,766,766,0,3002,2745,257
15,44,2,2,0,12,11,1
16,44,16,12,4,30,18,12
1,45,54,54,0,216,205,11
2,45,79,79,0,299,291,8
3,45,21,21,0,98,93,5
4,45,62,62,0,225,218,7
5,45,120,115,5,354,324,30
6,45,97,97,0,375,366,9
7,45,46,46,0,195,189,6
8,45,100,97,3,348,332,16
11,45,303,303,0,1147,1066,81
12,45,49,49,0,133,133,0
14,45,292,292,0,1457,1337,120
16,45,5,2,3,12,7,5
1,46,111,111,0,431,381,50
2,46,128,128,0,546,530,16
3,46,45,45,0,206,189,17
4,46,93,93,0,386,353,33
5,46,226,216,10,612,564,48
6,46,155,155,0,597,589,8
7,46,82,82,0,340,326,14
8,46,211,194,17,628,592,36
11,46,563,563,0,1944,1834,110
12,46,68,66,2,211,209,2
13,46,2,2,0,3,2,1
14,46,632,632,0,2845,2577,268
15,46,11,11,0,29,26,3
16,46,7,4,3,13,8,5
