row,col,hsa,hs,ha,thsa,ths,tha
1,1,5,5,0,25,24,1
2,1,118,118,0,591,580,11
3,1,133,133,0,1359,1272,87
9,1,13,13,0,25,25,0
14,1,52,52,0,225,209,16
16,1,3,3,0,11,10,1
17,1,14,14,0,44,43,1
23,1,10,10,0,28,24,4
24,1,8,8,0,16,15,1
1,2,4,4,0,23,23,0
2,2,403,403,0,2107,2068,39
3,2,523,523,0,3941,3720,221
9,2,19,19,0,66,66,0
14,2,148,148,0,737,708,29
16,2,6,6,0,27,27,0
17,2,52,52,0,195,182,13
18,2,2,2,0,16,16,0
22,2,2,2,0,126,7,119
23,2,12,12,0,69,53,16
24,2,17,17,0,36,31,5
1,3,6,6,0,32,28,4
2,3,1013,1013,0,3900,3843,57
3,3,1554,1554,0,7345,6957,388
7,3,72,72,0,337,289,48
8,3,19,19,0,89,78,11
9,3,40,40,0,130,126,4
10,3,64,64,0,280,276,4
14,3,611,599,12,1542,1481,61
15,3,5,5,0,16,16,0
16,3,22,22,0,55,54,1
17,3,126,125,1,344,329,15
18,3,14,14,0,45,45,0
19,3,6,2,4,21,5,16
22,3,28,5,23,172,8,164
23,3,19,19,0,98,73,25
24,3,58,56,2,118,109,9
1,4,14,14,0,33,33,0
2,4,581,581,0,2484,2456,28
3,4,1258,1258,0,5369,5027,342
7,4,49,49,0,219,195,24
8,4,37,37,0,133,132,1
9,4,18,18,0,72,72,0
10,4,52,51,1,173,172,1
14,4,465,450,15,1016,961,55
15,4,3,3,0,20,20,0
16,4,18,18,0,42,40,2
17,4,110,101,9,324,294,30
18,4,7,7,0,19,19,0
19,4,2,1,1,12,3,9
22,4,24,1,23,129,3,126
23,4,13,13,0,64,47,17
24,4,49,45,4,99,88,11
1,5,7,7,0,32,28,4
2,5,314,314,0,1248,1233,15
3,5,457,457,0,2214,2040,174
7,5,30,30,0,136,125,11
8,5,16,16,0,66,61,5
9,5,14,14,0,50,49,1
10,5,38,36,2,118,113,5
14,5,254,246,8,602,571,31
16,5,3,3,0,13,13,0
17,5,41,41,0,157,151,6
22,5,9,1,8,72,3,69
23,5,9,9,0,36,25,11
24,5,14,14,0,43,41,2
1,6,10,10,0,28,26,2
2,6,851,851,0,3303,3264,39
3,6,1453,1453,0,6100,5765,335
7,6,119,119,0,501,448,53
8,6,90,90,0,407,399,8
9,6,29,29,0,108,108,0
10,6,86,85,1,308,293,15
14,6,698,663,35,1617,1507,110
16,6,15,15,0,59,59,0
17,6,173,170,3,553,527,26
18,6,5,5,0,30,30,0
19,6,6,1,5,15,4,11
22,6,17,2,15,190,8,182
23,6,18,18,0,90,65,25
24,6,52,48,4,125,113,12
1,7,5,5,0,27,27,0
2,7,1082,1082,0,4200,4135,65
3,7,1950,1950,0,8307,7832,475
7,7,182,182,0,826,766,60
8,7,139,139,0,538,521,17
9,7,28,28,0,108,104,4
10,7,147,144,3,498,480,18
14,7,815,789,26,1894,1779,115
15,7,9,9,0,38,36,2
16,7,28,28,0,73,72,1
17,7,245,237,8,693,662,31
18,7,8,8,0,36,36,0
19,7,5,2,3,17,5,12
22,7,39,5,34,238,12,226
23,7,19,19,0,131,94,37
24,7,62,59,3,127,116,11
1,8,9,9,0,20,16,4
2,8,662,662,0,2551,2514,37
3,8,1104,1104,0,4815,4497,318
7,8,114,114,0,458,424,34
8,8,84,84,0,354,342,12
9,8,24,24,0,85,84,1
10,8,82,80,2,261,257,4
14,8,429,411,18,1046,969,77
16,8,18,18,0,49,48,1
17,8,157,153,4,467,446,21
18,8,10,10,0,25,25,0
19,8,2,0,2,8,3,5
22,8,31,4,27,122,12,110
23,8,23,23,0,74,53,21
24,8,41,38,3,79,73,6
1,9,3,3,0,13,12,1
2,9,306,306,0,1256,1236,20
3,9,497,497,0,2323,2163,160
7,9,51,51,0,239,225,14
8,9,43,43,0,167,166,1
9,9,13,13,0,42,42,0
10,9,35,34,1,146,138,8
14,9,206,197,9,518,477,41
16,9,5,5,0,19,19,0
17,9,66,62,4,236,225,11
18,9,2,2,0,7,7,0
22,9,7,0,7,50,0,50
23,9,4,4,0,27,16,11
24,9,25,24,1,49,45,4
1,10,4,4,0,30,28,2
2,10,931,931,0,3647,3590,57
3,10,1389,1389,0,6191,5789,402
7,10,120,120,0,562,531,31
8,10,110,110,0,495,484,11
9,10,25,25,0,92,89,3
10,10,129,128,1,427,419,8
14,10,685,655,30,1658,1532,126
16,10,16,16,0,59,56,3
17,10,300,286,14,909,858,51
18,10,12,12,0,39,39,0
19,10,8,1,7,18,4,14
22,10,32,1,31,229,5,224
23,10,20,20,0,97,71,26
24,10,61,58,3,142,131,11
1,11,11,11,0,35,34,1
2,11,1123,1123,0,4674,4613,61
3,11,1884,1884,0,8697,8166,531
7,11,196,196,0,843,785,58
8,11,163,163,0,685,660,25
9,11,24,24,0,103,103,0
10,11,192,189,3,655,634,21
14,11,872,839,33,2083,1931,152
16,11,13,13,0,56,55,1
17,11,450,439,11,1263,1214,49
18,11,9,9,0,44,44,0
19,11,5,2,3,23,8,15
22,11,37,6,31,198,8,190
23,11,20,20,0,110,83,27
24,11,95,94,1,203,190,13
1,12,4,4,0,21,21,0
2,12,535,535,0,2101,2069,32
3,12,1232,1232,0,5239,4906,333
7,12,116,116,0,475,437,38
8,12,95,95,0,356,340,16
9,12,18,18,0,59,57,2
10,12,105,100,5,353,341,12
14,12,431,412,19,987,909,78
15,12,3,3,0,20,20,0
16,12,18,18,0,45,45,0
17,12,299,294,5,842,819,23
18,12,5,5,0,22,22,0
19,12,5,3,2,11,4,7
22,12,13,2,11,58,3,55
23,12,12,12,0,44,35,9
24,12,31,29,2,60,57,3
2,13,263,263,0,1068,1045,23
3,13,355,355,0,1749,1637,112
7,13,20,20,0,111,106,5
8,13,11,11,0,90,86,4
9,13,12,12,0,26,26,0
10,13,10,10,0,32,32,0
14,13,98,95,3,235,221,14
16,13,3,3,0,14,14,0
17,13,14,13,1,67,63,4
19,13,2,0,2,3,0,3
22,13,5,1,4,35,3,32
24,13,5,5,0,26,24,2
1,14,3,3,0,18,16,2
2,14,645,645,0,2768,2736,32
3,14,852,852,0,4302,4064,238
7,14,58,58,0,286,267,19
8,14,59,59,0,249,245,4
9,14,8,8,0,25,25,0
10,14,24,22,2,133,127,6
14,14,228,223,5,598,572,26
16,14,10,10,0,42,37,5
17,14,72,71,1,242,233,9
18,14,8,8,0,21,21,0
22,14,24,1,23,122,4,118
23,14,13,13,0,50,39,11
24,14,39,38,1,81,78,3
1,15,8,8,0,24,19,5
2,15,1099,1099,0,4423,4363,60
3,15,1316,1316,0,6393,6060,333
7,15,116,116,0,555,528,27
8,15,106,106,0,453,445,8
9,15,22,22,0,68,66,2
10,15,42,42,0,229,224,5
14,15,372,355,17,1063,982,81
15,15,4,4,0,14,13,1
16,15,17,17,0,61,58,3
17,15,111,106,5,396,366,30
18,15,12,12,0,41,41,0
19,15,8,5,3,13,6,7
22,15,42,0,42,215,2,213
23,15,27,27,0,92,77,15
24,15,63,63,0,143,137,6
1,16,7,7,0,25,24,1
2,16,640,640,0,2367,2339,28
3,16,928,928,0,4361,4092,269
7,16,53,53,0,326,304,22
8,16,32,32,0,191,181,10
9,16,12,12,0,44,44,0
10,16,42,40,2,125,122,3
14,16,285,275,10,750,675,75
16,16,14,14,0,48,45,3
17,16,66,64,2,197,186,11
18,16,4,4,0,18,17,1
19,16,7,4,3,14,6,8
22,16,11,0,11,83,2,81
23,16,12,12,0,45,35,10
24,16,37,36,1,84,77,7
2,17,250,250,0,984,973,11
3,17,308,308,0,1855,1749,106
7,17,19,19,0,118,110,8
8,17,14,14,0,68,64,4
9,17,7,7,0,24,24,0
10,17,32,31,1,90,87,3
14,17,120,115,5,331,312,19
17,17,27,24,3,102,95,7
18,17,6,6,0,14,14,0
22,17,7,0,7,65,2,63
23,17,2,2,0,12,7,5
24,17,12,12,0,36,30,6
1,18,4,4,0,25,25,0
2,18,544,544,0,2159,2130,29
3,18,702,702,0,3446,3253,193
7,18,62,62,0,266,258,8
8,18,42,42,0,171,169,2
9,18,8,8,0,38,37,1
10,18,39,39,0,175,172,3
14,18,233,224,9,688,635,53
15,18,2,2,0,13,12,1
16,18,19,19,0,52,52,0
17,18,51,51,0,203,190,13
18,18,8,8,0,28,28,0
22,18,17,3,14,127,5,122
23,18,9,9,0,28,20,8
24,18,27,26,1,78,72,6
1,19,8,8,0,29,24,5
2,19,919,919,0,3715,3668,47
3,19,1204,1204,0,5797,5444,353
7,19,102,102,0,447,423,24
8,19,55,55,0,285,274,11
9,19,17,17,0,60,59,1
10,19,90,89,1,357,347,10
13,19,2,2,0,7,5,2
14,19,482,457,25,1220,1130,90
16,19,21,21,0,62,61,1
17,19,109,104,5,346,327,19
18,19,6,6,0,22,22,0
19,19,2,0,2,13,5,8
22,19,24,2,22,148,6,142
23,19,12,12,0,40,30,10
24,19,73,72,1,134,125,9
1,20,5,5,0,15,15,0
2,20,528,528,0,2032,1994,38
3,20,814,814,0,3869,3615,254
7,20,46,46,0,240,225,15
8,20,28,28,0,152,146,6
9,20,8,8,0,40,39,1
10,20,40,40,0,152,144,8
14,20,231,225,6,634,595,39
15,20,2,2,0,13,13,0
16,20,12,12,0,40,38,2
17,20,65,65,0,238,226,12
18,20,4,4,0,16,16,0
19,20,2,2,0,5,3,2
22,20,14,0,14,77,0,77
23,20,10,10,0,46,31,15
24,20,27,26,1,57,50,7
1,21,4,4,0,8,7,1
2,21,232,232,0,905,895,10
3,21,291,291,0,1626,1523,103
7,21,21,21,0,74,66,8
8,21,8,8,0,58,57,1
9,21,7,7,0,30,29,1
10,21,26,25,1,110,104,6
14,21,119,115,4,316,287,29
16,21,8,8,0,21,20,1
17,21,22,22,0,108,104,4
18,21,6,6,0,18,18,0
22,21,11,1,10,43,4,39
23,21,3,3,0,9,4,5
24,21,6,5,1,18,15,3
1,22,3,3,0,22,19,3
2,22,531,531,0,2030,2008,22
3,22,581,581,0,3472,3252,220
7,22,51,51,0,252,237,15
8,22,36,36,0,164,159,5
9,22,10,10,0,42,42,0
10,22,39,38,1,163,157,6
14,22,238,232,6,648,599,49
15,22,3,3,0,14,13,1
16,22,13,13,0,48,48,0
17,22,71,69,2,297,286,11
18,22,12,12,0,30,30,0
19,22,2,1,1,6,2,4
22,22,22,3,19,117,7,110
23,22,4,4,0,17,12,5
24,22,28,28,0,77,74,3
1,23,6,6,0,24,19,5
2,23,910,910,0,3589,3535,54
3,23,1270,1270,0,6274,5883,391
7,23,69,69,0,376,358,18
8,23,46,46,0,262,257,5
9,23,21,21,0,72,71,1
10,23,87,86,1,303,299,4
14,23,467,451,16,1217,1107,110
15,23,5,5,0,41,35,6
16,23,17,17,0,47,45,2
17,23,111,108,3,420,403,17
18,23,12,12,0,35,35,0
19,23,7,3,4,18,7,11
22,23,19,2,17,132,5,127
23,23,13,13,0,63,41,22
24,23,56,53,3,140,131,9
1,24,2,2,0,14,14,0
2,24,576,576,0,2069,2033,36
3,24,733,733,0,3781,3551,230
7,24,61,61,0,257,242,15
8,24,40,40,0,173,170,3
9,24,7,7,0,29,28,1
10,24,50,47,3,168,159,9
14,24,312,294,18,742,675,67
15,24,4,4,0,25,20,5
16,24,5,5,0,26,26,0
17,24,81,75,6,273,256,17
18,24,7,7,0,16,16,0
19,24,2,1,1,7,1,6
22,24,11,1,10,68,3,65
23,24,6,6,0,29,22,7
24,24,25,23,2,73,66,7
1,25,2,2,0,9,8,1
2,25,212,212,0,850,843,7
3,25,278,278,0,1524,1442,82
7,25,25,25,0,80,75,5
8,25,9,9,0,44,41,3
9,25,2,2,0,14,14,0
10,25,21,20,1,85,80,5
14,25,103,98,5,303,273,30
16,25,10,10,0,19,19,0
17,25,29,28,1,141,135,6
18,25,4,4,0,9,9,0
22,25,5,1,4,36,1,35
23,25,5,5,0,20,13,7
24,25,7,7,0,29,29,0
1,26,7,7,0,23,20,3
2,26,432,432,0,1856,1830,26
3,26,545,545,0,3009,2852,157
7,26,39,39,0,208,197,11
8,26,22,22,0,142,139,3
9,26,9,9,0,37,37,0
10,26,51,47,4,240,215,25
14,26,242,226,16,642,576,66
15,26,3,3,0,13,12,1
16,26,15,15,0,48,47,1
17,26,76,73,3,254,242,12
18,26,8,8,0,27,27,0
19,26,4,3,1,8,4,4
22,26,15,2,13,78,3,75
23,26,10,10,0,39,27,12
24,26,31,31,0,71,66,5
1,27,17,17,0,43,40,3
2,27,854,854,0,3421,3372,49
3,27,1047,1047,0,5665,5336,329
7,27,87,87,0,391,369,22
8,27,59,59,0,253,247,6
9,27,13,13,0,62,62,0
10,27,83,80,3,298,290,8
14,27,456,436,20,1069,993,76
16,27,23,23,0,71,71,0
17,27,135,132,3,444,425,19
18,27,9,9,0,25,25,0
19,27,4,2,2,11,7,4
22,27,26,1,25,142,6,136
23,27,6,6,0,38,29,9
24,27,36,34,2,87,82,5
1,28,3,3,0,17,17,0
2,28,492,492,0,1864,1851,13
3,28,717,717,0,3667,3439,228
7,28,49,49,0,259,244,15
8,28,32,32,0,151,147,4
9,28,13,13,0,45,45,0
10,28,47,47,0,153,150,3
14,28,225,213,12,574,525,49
15,28,3,3,0,15,15,0
16,28,12,12,0,49,48,1
17,28,76,76,0,233,227,6
18,28,9,9,0,17,16,1
22,28,11,0,11,51,1,50
23,28,5,5,0,35,20,15
24,28,16,15,1,48,43,5
1,29,3,3,0,10,8,2
2,29,208,208,0,873,871,2
3,29,219,219,0,1429,1327,102
7,29,11,11,0,80,74,6
8,29,15,15,0,59,58,1
10,29,14,14,0,67,65,2
14,29,97,89,8,284,257,27
16,29,5,5,0,29,28,1
17,29,29,29,0,86,84,2
22,29,2,0,2,21,1,20
23,29,6,6,0,10,10,0
24,29,9,8,1,13,11,2
1,30,9,9,0,32,31,1
2,30,503,503,0,2012,1990,22
3,30,573,573,0,3065,2886,179
7,30,26,26,0,137,126,11
8,30,15,15,0,71,70,1
9,30,7,7,0,35,33,2
10,30,55,55,0,163,160,3
14,30,202,185,17,572,505,67
15,30,2,2,0,12,12,0
16,30,15,15,0,42,40,2
17,30,68,68,0,219,209,10
18,30,5,5,0,16,14,2
19,30,3,2,1,6,2,4
22,30,16,1,15,91,6,85
23,30,7,7,0,35,19,16
24,30,24,23,1,52,51,1
1,31,15,15,0,36,33,3
2,31,1164,1164,0,3544,3486,58
3,31,1640,1640,0,5779,5475,304
4,31,626,626,0,2358,1780,578
5,31,294,294,0,1394,948,446
6,31,126,126,0,577,388,189
7,31,156,156,0,352,332,20
8,31,78,78,0,205,198,7
9,31,17,17,0,61,59,2
10,31,145,140,5,305,295,10
14,31,580,552,28,1145,1048,97
15,31,5,5,0,11,10,1
16,31,19,19,0,31,31,0
17,31,223,214,9,508,476,32
18,31,11,11,0,31,31,0
19,31,3,2,1,8,3,5
20,31,62,62,0,247,238,9
21,31,6,6,0,24,19,5
22,31,31,2,29,112,6,106
23,31,21,21,0,63,48,15
24,31,50,48,2,84,78,6
25,31,90,60,30,238,147,91
1,32,8,8,0,24,23,1
2,32,875,875,0,2407,2371,36
3,32,1464,1464,0,4661,4401,260
4,32,676,676,0,2343,1918,425
5,32,349,349,0,1243,963,280
6,32,122,122,0,501,366,135
7,32,110,110,0,234,219,15
8,32,48,48,0,127,121,6
9,32,10,10,0,30,29,1
10,32,96,95,1,199,190,9
13,32,2,2,0,5,3,2
14,32,430,408,22,819,758,61
15,32,4,4,0,8,8,0
16,32,10,10,0,31,30,1
17,32,151,147,4,330,314,16
18,32,10,10,0,17,17,0
20,32,36,36,0,128,121,7
21,32,6,6,0,37,26,11
22,32,34,2,32,81,3,78
23,32,7,7,0,16,12,4
24,32,32,32,0,51,42,9
25,32,81,48,33,179,102,77
2,33,331,331,0,990,972,18
3,33,600,600,0,1989,1883,106
4,33,363,363,0,1377,1085,292
5,33,198,198,0,811,602,209
6,33,84,84,0,312,223,89
7,33,57,57,0,123,119,4
8,33,23,23,0,73,70,3
9,33,8,8,0,16,16,0
10,33,45,44,1,128,126,2
14,33,193,189,4,368,344,24
15,33,2,2,0,4,4,0
16,33,8,8,0,19,18,1
17,33,60,59,1,139,136,3
20,33,16,16,0,90,86,4
21,33,3,3,0,16,14,2
22,33,10,3,7,48,5,43
23,33,2,2,0,16,9,7
24,33,25,24,1,32,30,2
25,33,41,24,17,103,55,48
26,33,2,0,2,4,1,3
1,34,7,7,0,25,23,2
2,34,986,986,0,2764,2723,41
3,34,1478,1478,0,4733,4482,251
4,34,966,966,0,3328,2787,541
5,34,500,500,0,1929,1526,403
6,34,190,190,0,787,601,186
7,34,133,133,0,289,266,23
8,34,57,57,0,165,156,9
9,34,17,17,0,46,46,0
10,34,156,151,5,355,348,7
13,34,4,4,0,11,8,3
14,34,598,547,51,1068,968,100
15,34,7,7,0,10,10,0
16,34,26,26,0,51,49,2
17,34,178,173,5,410,385,25
18,34,10,10,0,23,22,1
19,34,3,1,2,8,4,4
20,34,66,66,0,305,292,13
21,34,6,6,0,46,33,13
22,34,66,0,66,183,3,180
23,34,8,8,0,39,29,10
24,34,30,29,1,45,44,1
25,34,131,96,35,347,214,133
26,34,3,1,2,4,2,2
1,35,8,8,0,35,32,3
2,35,1212,1212,0,3335,3284,51
3,35,1986,1986,0,6504,6191,313
4,35,1124,1124,0,3771,3178,593
5,35,641,641,0,2166,1720,446
6,35,231,231,0,831,652,179
7,35,187,187,0,397,377,20
8,35,76,76,0,210,198,12
9,35,22,22,0,71,71,0
10,35,148,142,6,427,413,14
12,35,3,3,0,17,15,2
13,35,11,11,0,27,24,3
14,35,625,587,38,1145,1050,95
15,35,3,3,0,18,18,0
16,35,16,16,0,48,44,4
17,35,198,194,4,473,446,27
18,35,8,8,0,17,17,0
19,35,2,1,1,11,5,6
20,35,100,100,0,373,354,19
21,35,6,6,0,48,30,18
22,35,71,4,67,203,10,193
23,35,13,13,0,39,28,11
24,35,33,32,1,58,57,1
25,35,155,105,50,401,248,153
1,36,5,5,0,22,21,1
2,36,776,776,0,2164,2124,40
3,36,1423,1423,0,4776,4465,311
4,36,721,721,0,2401,1986,415
5,36,363,363,0,1361,1048,313
6,36,165,165,0,555,433,122
7,36,109,109,0,268,259,9
8,36,46,46,0,140,133,7
9,36,10,10,0,29,29,0
10,36,118,115,3,287,279,8
13,36,2,2,0,9,9,0
14,36,406,384,22,775,713,62
15,36,4,4,0,11,11,0
16,36,10,10,0,29,28,1
17,36,143,140,3,370,351,19
18,36,4,4,0,17,17,0
19,36,3,1,2,9,5,4
20,36,60,60,0,205,191,14
21,36,9,9,0,48,39,9
22,36,45,5,40,115,8,107
23,36,9,9,0,45,29,16
24,36,19,17,2,30,27,3
25,36,109,75,34,279,173,106
1,37,2,2,0,12,8,4
2,37,321,321,0,924,910,14
3,37,592,592,0,1973,1847,126
4,37,353,353,0,1349,1048,301
5,37,198,198,0,855,602,253
6,37,78,78,0,352,228,124
7,37,45,45,0,99,92,7
8,37,12,12,0,47,45,2
9,37,8,8,0,18,18,0
10,37,53,51,2,159,154,5
14,37,196,183,13,352,320,32
15,37,4,4,0,10,10,0
16,37,7,7,0,15,15,0
17,37,74,71,3,199,188,11
20,37,34,34,0,130,118,12
22,37,23,3,20,62,5,57
23,37,4,4,0,16,10,6
24,37,16,14,2,34,30,4
25,37,37,31,6,105,71,34
1,38,6,6,0,21,19,2
2,38,897,897,0,2554,2509,45
3,38,1453,1453,0,4902,4629,273
4,38,1028,1028,0,3613,2941,672
5,38,513,513,0,2016,1531,485
6,38,203,203,0,819,595,224
7,38,132,132,0,301,274,27
8,38,50,50,0,153,149,4
9,38,18,18,0,63,63,0
10,38,178,167,11,433,414,19
11,38,5,5,0,12,11,1
12,38,4,4,0,19,18,1
13,38,7,7,0,23,23,0
14,38,514,480,34,968,881,87
15,38,5,5,0,14,13,1
16,38,10,10,0,27,27,0
17,38,231,223,8,571,548,23
18,38,2,2,0,9,9,0
19,38,4,1,3,10,4,6
20,38,104,104,0,364,338,26
21,38,9,9,0,39,32,7
22,38,67,1,66,203,6,197
23,38,19,19,0,58,40,18
24,38,45,40,5,75,63,12
25,38,133,94,39,323,199,124
1,39,13,13,0,29,28,1
2,39,1140,1140,0,3255,3186,69
3,39,2037,2037,0,7048,6649,399
4,39,1250,1250,0,4161,3441,720
5,39,601,601,0,2264,1721,543
6,39,242,242,0,921,688,233
7,39,168,168,0,336,306,30
8,39,69,69,0,180,174,6
9,39,35,35,0,88,88,0
10,39,329,323,6,760,727,33
11,39,2,2,0,6,5,1
14,39,712,673,39,1322,1206,116
15,39,5,5,0,18,18,0
16,39,8,8,0,25,23,2
17,39,317,307,10,728,697,31
18,39,8,8,0,20,20,0
19,39,2,1,1,6,1,5
20,39,100,100,0,338,319,19
21,39,5,5,0,60,45,15
22,39,71,2,69,196,7,189
23,39,29,29,0,73,57,16
24,39,40,39,1,78,75,3
25,39,141,90,51,372,215,157
1,40,3,3,0,18,16,2
2,40,637,637,0,1756,1732,24
3,40,1535,1535,0,5091,4744,347
4,40,612,612,0,2278,1846,432
5,40,323,323,0,1239,948,291
6,40,130,130,0,536,408,128
7,40,112,112,0,242,237,5
8,40,34,34,0,99,96,3
9,40,13,13,0,38,37,1
10,40,172,171,1,406,393,13
11,40,2,2,0,5,5,0
12,40,2,2,0,8,6,2
13,40,5,5,0,8,7,1
14,40,363,340,23,728,651,77
15,40,3,3,0,6,6,0
16,40,11,11,0,30,29,1
17,40,282,277,5,677,658,19
18,40,4,4,0,15,15,0
19,40,5,3,2,8,4,4
20,40,42,42,0,151,142,9
21,40,4,4,0,32,21,11
22,40,24,3,21,83,5,78
23,40,7,7,0,23,17,6
24,40,24,23,1,41,39,2
25,40,76,53,23,194,110,84
1,41,4,4,0,17,12,5
2,41,285,285,0,873,860,13
3,41,407,407,0,1643,1547,96
4,41,335,335,0,1440,1046,394
5,41,184,184,0,865,607,258
6,41,66,66,0,367,231,136
7,41,42,42,0,125,120,5
8,41,20,20,0,59,57,2
9,41,4,4,0,9,9,0
10,41,16,15,1,57,56,1
14,41,82,76,6,152,139,13
16,41,6,6,0,10,10,0
17,41,26,26,0,47,46,1
18,41,2,2,0,3,3,0
19,41,2,2,0,3,3,0
20,41,16,16,0,83,75,8
21,41,3,3,0,14,13,1
22,41,16,2,14,35,3,32
23,41,4,4,0,17,12,5
24,41,8,7,1,20,19,1
25,41,24,17,7,58,37,21
1,42,5,5,0,23,20,3
2,42,591,591,0,1815,1796,19
3,42,882,882,0,3428,3183,245
4,42,627,627,0,2716,2083,633
5,42,342,342,0,1660,1195,465
6,42,139,139,0,694,495,199
7,42,76,76,0,182,168,14
8,42,38,38,0,113,107,6
9,42,7,7,0,26,25,1
10,42,45,45,0,174,171,3
14,42,173,162,11,369,334,35
16,42,9,9,0,15,15,0
17,42,24,23,1,57,55,2
18,42,4,4,0,6,6,0
19,42,2,1,1,4,2,2
20,42,66,66,0,261,244,17
21,42,2,2,0,14,13,1
22,42,47,1,46,137,4,133
23,42,3,3,0,14,8,6
24,42,23,22,1,44,41,3
25,42,55,36,19,150,81,69
1,43,6,6,0,25,23,2
2,43,1015,1015,0,3019,2954,65
3,43,1585,1585,0,5830,5479,351
4,43,1036,1036,0,4259,3351,908
5,43,545,545,0,2498,1857,641
6,43,241,241,0,1027,751,276
7,43,151,151,0,343,332,11
8,43,70,70,0,188,185,3
9,43,17,17,0,46,45,1
10,43,102,97,5,336,326,10
13,43,3,3,0,9,8,1
14,43,362,336,26,774,690,84
15,43,5,5,0,27,23,4
16,43,17,17,0,41,39,2
17,43,73,70,3,193,179,14
18,43,2,2,0,5,5,0
19,43,8,4,4,13,5,8
20,43,82,82,0,294,279,15
21,43,5,5,0,46,34,12
22,43,53,6,47,149,9,140
23,43,9,9,0,32,21,11
24,43,19,18,1,40,38,2
25,43,122,72,50,326,180,146
1,44,3,3,0,14,12,2
2,44,704,704,0,1910,1872,38
3,44,1196,1196,0,4186,3962,224
4,44,654,654,0,2531,2009,522
5,44,341,341,0,1451,1069,382
6,44,149,149,0,603,439,164
7,44,84,84,0,214,202,12
8,44,47,47,0,131,131,0
10,44,85,85,0,235,228,7
13,44,2,2,0,4,4,0
14,44,324,301,23,643,576,67
15,44,7,7,0,20,19,1
16,44,6,6,0,21,20,1
17,44,52,51,1,137,127,10
18,44,3,3,0,7,7,0
19,44,3,2,1,6,3,3
20,44,43,43,0,174,164,10
22,44,36,5,31,96,6,90
23,44,3,3,0,13,9,4
24,44,12,12,0,25,25,0
25,44,104,73,31,231,145,86
1,45,2,2,0,11,9,2
2,45,296,296,0,833,811,22
3,45,501,501,0,1843,1754,89
4,45,301,301,0,1334,986,348
5,45,176,176,0,799,567,232
6,45,73,73,0,326,227,99
7,45,23,23,0,73,73,0
8,45,11,11,0,45,44,1
10,45,34,34,0,102,100,2
14,45,128,116,12,261,226,35
15,45,2,2,0,7,7,0
16,45,4,4,0,10,9,1
17,45,18,17,1,62,59,3
20,45,25,25,0,104,96,8
21,45,4,4,0,16,12,4
22,45,13,1,12,56,3,53
23,45,2,2,0,5,2,3
24,45,3,3,0,7,6,1
25,45,28,16,12,108,54,54
1,46,4,4,0,16,13,3
2,46,544,544,0,1697,1643,54
3,46,854,854,0,2835,2696,139
4,46,578,578,0,2360,1859,501
5,46,311,311,0,1323,986,337
6,46,103,103,0,554,395,159
7,46,55,55,0,144,128,16
8,46,30,30,0,110,103,7
9,46,6,6,0,19,19,0
10,46,47,46,1,158,152,6
12,46,4,4,0,6,6,0
14,46,294,268,26,610,553,57
16,46,6,6,0,11,9,2
17,46,43,38,5,158,147,11
18,46,4,4,0,7,7,0
20,46,56,56,0,199,189,10
21,46,4,4,0,10,10,0
22,46,39,5,34,93,5,88
23,46,2,2,0,6,4,2
24,46,12,11,1,29,26,3
25,46,52,34,18,163,99,64
26,46,2,2,0,2,2,0
